NO      Assests/Walls/intra/abouabra.png
SO      Assests/Walls/intra/mtaib.png
EA      Assests/Walls/intra/mbaanni.png
WE      Assests/Walls/intra/ykhayri.png

C        56,56,56
F        112,112,112

                            1111111111111                      
     111111                 1000000000001                      
     100001      1111111111110000000000011111                  
     100001      1000000000010000000000010001                  
     1000001     10000000000C00000000000C0001                  
     1000001     1000000000010000000000010001                  
     11111C11111 1000111111110000000000011111                  
     10000000001 10001      1000000000001                      
     1000000000111000111     11111C111111                      
     1000000000100000001        10001                          
     1000000000C00000001        10001                          
     1000000000100000001        10001                          
111111000000000111111111        10001                          
1000110000000001                10001                          
1000111111C1111            111111000111                        
1000100010001              100C00000001                        
11C1100010001              100111000111                        
1000111110001              1001110001                          
1000100010001              1001110G01                          
1000C00010001              1111110001                          
1000100010001                   10001                          
1000111111C11111                11C11                1111111111
1000110000000001          111111000001111111         1000000001
1000110000000001          100000000000000011         1000000001
1000110000000001          100j000000000l001111111111110000G0001
1000010000000001          1000m00n000o0p00010000000001000000001
10000C0000000001          100000G0000000000C0000G0000C000000001
1000010000000001          100E0000000k0000010000000001000000001
1000110000000001          10000000000000001111000011110000G0001
1000110000000001          100g0h0i0000000011111001   1000000001
1000110000000001          11111100000111111   1001   1000000001
1000111111C11111               111C11         1001   1110110111
1000111110001                   10001         1001   1111111111
1000111110001                   10001         1001             
1000100010001                   10G01         100111111111111  
1000C00010001                   10001         100111010101011  
1000100010001                   10001         100010000000001  
1000111110001                   10001         1000C0000000001  
1000111110001111111111111       10001         100010000000001  
100000000000000001000000111     10001         111111010101011  
10000000000000000C000000C01     10001         111111111111111  
100000000000000001000000111     10001                          
111111111111111111C111111       10001                          
         11100100C001      1111111C1111111                     
         10C001001011      100001000100001                     
         111000001111      10000C000C00001                     
           11C1111         100001000100001                     
            1001           100001000100001                     
            1001           111111000111111                     
            1111           100001000100001                     
                           10000C000C00001                     
                           100001000100001                     
                           111111000111111                     
                           100000000000001                     
                           100000000000001                     
                           100000000000001                     
                           111111111111111                     